10000001110000000011111000111100111100100001000000001000000001
00111100110011111001110010011100011100110011111001111001111111
00111111110011111001100111001100001100110011111001111001111111
00111000010000000011001111100100100100110011111001111000000111
00111100110011100111000000000100110000110011111001111001111111
00111100110011110011001111100100111000110011111001111001111111
10000001110011111001001111100100111100100001111001111000000001

granite