5 6 3 2 1 4
1 2 4 5 6 3
3 4 6 1 5 2
2 5 1 3 4 6
6 3 5 4 2 1
4 1 2 6 3 5
