   |  2   1 1
   |4 1 1 1 1
___|__________
2 1|x x _ x _
2 1|x x _ _ x
1 1|x _ _ x _
  1|x _ _ _ _
2 1|_ x x _ x
